8
20
WWWWWWW++W+++++++W+W
W++H+WW++W++W++W+++W
WS+HH+++++++W++WWWWW
WWWWWWW++W++++++++++
WWWWWWW++W++W++WWWW+
W++HH+++++++W++W++W+
WS+H+WW++W+++++WW+W+
WWWWWWW++W++W+++++W+