8
20
WWWWW+++W++++WW++W++
WS+HWWWW+WWW+W+++W++
WW+H+++++WW+WW++W+W+
WWWWWWWW+WW+++++WW++
WWWWWWWW++++W+W++WW+
WW+H+++++WW+WWW++WW+
WS+HWWW++W++W++W++W+
WWWWWW+WW++W++W+W+++